9 4
-- BEGIN
+-+-+-+-+-+-+-+-+-+
| |   | | |       |
+ + + + + + +-+-+-+
|   | |   | |     |
+-+-+ + + + + + + +
|     | | |   | | |
+ +-+-+ + + +-+ + +
|       |   |   | |
+-+-+-+-+-+-+-+-+-+
-- END
Problem (1,1) (9,4)
Problem (1,1) (9,1)
Problem (2,1) (7,4)
